111111111111
100P0001C1E1
101C10010101
1C10000CC001
100000000001
101001110001
101000000001
111111000001
1C10C1100111
101010110101
100000000001
111111111111
